==============================
|+***************************|
|****************************|
|****************************|
|****************************|
|****************************|
|***************************X|
|****************************|
|****************************|
|****************************|
|****************************|
==============================