==============================
|**Z**#*******+**************|
|*****#**********************|
|######**********************|
|***************C************|
|******************##########|
|***************************X|
|****************************|
|*****W**********************|
|****************************|
|****************************|
==============================