==============================
|*************+*****#********|
|***********#########********|
|****************************|
|********#*******************|
|******W*#*******************|
|********#******************X|
|********#*******************|
|********#*********##########|
|********#*******************|
|********#*******************|
==============================