==============================
|*****************#*********+|
|*****************#**########|
|*****************#**#*******|
|X#################**#*******|
|********************#*******|
|#####################*******|
|****************************|
|****************************|
|***W************************|
==============================