==============================
|*************+*******#******|
|*********************#******|
|***********###########******|
|***********#**C*************|
|***********###########******|
|***************************X|
|****************************|
|*****W**********************|
|****************************|
|****************************|
==============================