==============================
|**Z***#******+**************|
|#######*********************|
|*************#**************|
|*************#**************|
|*************#**************|
|*************#*************X|
|*************#**************|
|*************#**************|
|******************W*********|
|*P**************************|
==============================